###################################################
W.................................................#
W.................................................#
W.................................................#
W.....WWWWWWWWWWW.................................#
W.................................................#
W.................................................#
W.................................................#
W.................................................#
W.................................................#
W.................................................#
W.................................................#
W.................................................#
W.................................................#
W.................................................#
W.................................................#
W.................................................#
W.................................................#
W.................................................#
W.................................................#
W.................................................#
W.................................................#
###################################################